
NO rander/textures/eagle.xpm

SO rander/textures/graystone.xpm

EA rander/textures/redbrick.xpm
F 220,111,156
WE rander/textures/mossystone.xpm

C 225,111,0

 1111111111111111111111   
100000000000000000000001   
 1000000000000000000001
  1000000000S000000001   
   100000000000000001   
    1000000000000001  
     10000000000001   
      100000000001
       1000000001   
        10000001   
         101101   
          1001
           11